1111111111111111111111111
100000000000000000000C1C1
1000100010110111100000101
1000000011C00000010000101
1000000000000000000000001
100000C001001010010000001
10000000000000010000000E1
110000000100101C100001111
1101100001001000110000011
10000000000000000000000P1
1111111111111111111111111
